wwwwwwwwwwwwww
w            w
w            w
w   b        w
w            w
w          m w
w            w
w            w
w   p        w
w            w
wwwwwwwwwwwwww