wwwwwwwwwwwwwwwwwwwwwwwwwwwwwwwwww
w      w    w    w      w        w
w                                w
w                                w
w      w    w    w      w        w
wwwwwwwww  ww    www  www        w
w    w      w    w      w        w
w           ww  ww      w        w
w                w      w        w
w    w           w      w        w
w    w      w    w      w        w
w    w      w    w      w        w
www  www  wwww  wwww  wwwwww  wwww
w                                w
w                                w
wwww     wwww  ww    wwwww  wwwwww
w          w    w    w           w
w          w    w    w           w
w          w    w    w           w
w          wwwwww    wwwwwwwwwwwww
wbbbbbbbbbbw                     w
wbbbbbbbbbbw                     w
wbbbbbbbbbbw                     w
wbbbbbbbbbbw                     w
wwwwwwwwwwwwwwwwwwwwwwwwwwwwwwwwww